  |----|----|----|----|
a |    |    |    |+100|
  |----|----|----|----|
b |    |XXXX|    |-100|
  |----|----|----|----|
c | :) |    |    |    |
  |----|----|----|----|
     1    2    3    4 
Nonterminal R[s] = -4