  |----|----|----|----|
a |  E |  E |  E |+100|
  |----|----|----|----|
b |  N |XXXX|  N |-100|
  |----|----|----|----|
c |  N |  W |  W |  W |
  |----|----|----|----|
     1    2    3    4 
