  |----|----|----|----|
a |-100|-100|-100|+100|
  |----|----|----|----|
b |  E |  E |  E |  N |
  |----|----|----|----|
c |  N |-100|-100|-100|
  |----|----|----|----|
     1    2    3    4 
