  |----|----|----|----|
a |-100|-100|-100|+100|
  |----|----|----|----|
b |    |    |    |    |
  |----|----|----|----|
c | :) |-100|-100|-100|
  |----|----|----|----|
     1    2    3    4 
Nonterminal R[s] = -3