  |----|----|----|----|
a |-100|-100|-100|+100|
  |----|----|----|----|
b | -97| -83| -51| +31|
  |----|----|----|----|
c |-103|-100|-100|-100|
  |----|----|----|----|
     1    2    3    4 
