  |----|----|----|----|
a |  E |  E |  E |+100|
  |----|----|----|----|
b |  S |XXXX|  W |-100|
  |----|----|----|----|
c |  E |  N |  W |  S |
  |----|----|----|----|
     1    2    3    4 
