  |----|----|----|----|
a |  E |  E |  E |+100|
  |----|----|----|----|
b |  N |XXXX|  W |-100|
  |----|----|----|----|
c |  E |  N |  W |  S |
  |----|----|----|----|
     1    2    3    4 
