  |----|----|----|----|
a |  E |  E |  E |+100|
  |----|----|----|----|
b |-100|-100|-100|  N |
  |----|----|----|----|
c |  E |  E |  E |  N |
  |----|----|----|----|
     1    2    3    4 
